"Address A","Port A","Address B","Port B","Packets","Bytes","Packets A → B","Bytes A → B","Packets B → A","Bytes B → A","Rel Start","Duration","Bits/s A → B","Bits/s B → A"
"192.168.7.33",57918,"172.26.211.223",6002,36,3119,19,1746,17,1373,160.630453774,5.758671346,2425.5595016204975,1907.3844190864509
"192.168.7.33",57920,"172.26.211.223",6002,1342,1577207,1084,1559051,258,18156,160.718960079,5.642827442999987,2210311.785357217,25740.287376709053
"192.168.7.33",57922,"172.26.211.223",6002,38,3236,19,1727,19,1509,167.582895542,6.333269763000004,2181.4955808001937,1906.124395731032
"192.168.7.33",57924,"172.26.211.223",6002,1319,1479653,1013,1456669,306,22984,167.662421724,5.493197691999995,2121415.0033178907,33472.67116706568
"192.168.7.33",57926,"172.26.211.223",6002,36,2629,27,2001,9,628,174.608654509,100.99127955399999,158.50873531551335,49.74686945434402
"192.168.7.33",57928,"172.26.211.223",6002,1722,2242719,1550,2231023,172,11696,174.686823064,57.40494826099999,310917.1690017143,1629.9640158994555
"192.168.7.33",57930,"172.26.211.223",6002,23,1744,12,968,11,776,235.725430078,2.002398524,3867.3620196895426,3100.2819496684765
"192.168.7.33",57932,"172.26.211.223",6002,465,531463,374,525263,91,6200,236.435377975,92.328477147,45512.54531480743,537.2123697115655
"192.168.7.33",57934,"172.26.211.223",6002,24,1823,14,1127,10,696,237.648776732,6.991134182000025,1289.6333792610317,796.4372954442573
"192.168.7.33",57936,"172.26.211.223",6002,1442,1604125,1099,1580681,343,23444,238.799291924,5.8398452039999995,2165373.834110963,32115.919762999256
"192.168.7.33",57938,"172.26.211.223",6002,37,3229,19,1788,18,1441,244.682225904,6.656091583000006,2149.008892325511,1731.9473231773275
"192.168.7.33",57940,"172.26.211.223",6002,246,259539,180,255483,66,4056,245.161748208,5.499563548999987,371641.1278439806,5900.104564825
"192.168.7.33",57942,"172.26.211.223",6002,26,1920,13,1032,13,888,251.670639363,7.34529559500001,1123.9847182759959,967.1496413072523
"192.168.7.33",57944,"172.26.211.223",6002,418,427625,293,418429,125,9196,256.799395809,2.2694371450000403,1475005.3806843548,32416.84845164491
"192.168.7.33",57946,"172.26.211.223",6002,35,3025,18,1653,17,1372,258.693113663,6.465572071999986,2045.2946549414055,1697.606936829769
"192.168.7.33",57948,"172.26.211.223",6002,552,539212,369,526684,183,12528,259.121090703,5.860741012999995,718931.6147316343,17100.909215692736
"192.168.7.33",57950,"172.26.211.223",6002,23,1728,13,1032,10,696,270.78743801,2.4442087079999624,3377.780290601979,2278.037870405986
"192.168.7.33",57952,"172.26.211.223",6002,175,190805,133,187709,42,3096,271.066775902,3.9869218529999557,376649.4692816886,6212.311380360601
"192.168.7.33",57954,"172.26.211.223",6002,12,1003,8,717,4,286,277.739404375,1.9194914230000109,2988.2915501831694,1191.9824035598137
"192.168.7.33",57956,"172.26.211.223",6002,30,2180,15,1168,15,1012,284.675744716,3.011541862999991,3102.729573445756,2688.32391123896
"192.168.7.33",57958,"172.26.211.223",6002,86,94009,68,92613,18,1396,284.823375864,10.11410946899997,73254.4968265265,1104.2000320671073
"192.168.7.33",57960,"172.26.211.223",6002,20,1524,11,896,9,628,287.228046555,6.575592921000009,1090.0918116612818,764.0375644233092
"192.168.7.33",57962,"172.26.211.223",6002,87,90007,64,88211,23,1796,293.372416255,1.7177173590000052,410828.9389418681,8364.589159397297
"192.168.7.33",57964,"172.26.211.223",6002,33,2909,18,1674,15,1235,293.710230827,6.565709798,2039.6880782149974,1504.787799638902
"192.168.7.33",57966,"172.26.211.223",6002,126,120303,84,117051,42,3252,295.161765744,5.048112164000031,185496.67075107293,5153.609736631803
"192.168.7.33",57968,"172.26.211.223",6002,39,3331,20,1822,19,1509,300.628650663,6.059385092000014,2405.5246165562517,1992.2813646451064
"192.168.7.33",57970,"172.26.211.223",6002,165,153007,106,148775,59,4232,300.8927582,5.747928713000022,207065.89441656417,5890.121762197275
"192.168.7.33",58156,"172.26.211.223",6001,35,3047,18,1675,17,1372,321.648422537,5.471840777000011,2448.9016669353227,2005.9063206180674
"192.168.7.33",58158,"172.26.211.223",6001,282,246527,169,238247,113,8280,321.915072862,5.142339830000026,370643.72698215675,12881.295711644882
"192.168.7.33",58160,"172.26.211.223",6001,23,1744,12,968,11,776,328.646792672,6.908838485999979,1120.8830566371448,898.5591445768846
"192.168.7.33",58162,"172.26.211.223",6001,173,153807,106,148775,67,5032,334.384179528,4.757551281000019,250170.71381936307,8461.495761647016
"192.168.7.33",58164,"172.26.211.223",6001,18,1386,9,760,9,626,340.696499176,1.8618619460000332,3265.5482395255376,2689.7805236091926
"192.168.7.33",58166,"172.26.211.223",6001,20,1650,11,1011,9,639,342.757624939,6.943061204999992,1164.904033133899,736.2746559570342
"192.168.7.33",58168,"172.26.211.223",6001,32,2304,16,1236,16,1068,349.742626459,9.241879365999978,1069.9122557666183,924.4872889633886
"192.168.7.33",58170,"172.26.211.223",6001,247,212689,145,205013,102,7676,354.930702823,5.538918384999988,296105.46428009943,11086.641060879278
"192.168.7.33",58172,"172.26.211.223",6001,23,1740,12,964,11,776,357.282181154,7.350428033000014,1049.1906002448695,844.5766657572808
"192.168.7.33",58174,"172.26.211.223",6001,277,234691,160,226643,117,8048,360.527356872,7.334108113000013,247220.78977621376,8778.708877481185
"192.168.7.33",58176,"172.26.211.223",6001,20,1559,14,1137,6,422,364.897284805,76.46266290299997,118.96002120066268,44.15226820288448
"192.168.7.33",57994,"172.26.211.223",6002,34,3276,18,1959,16,1317,377.650318972,7.035180179000008,2227.6614956900285,1497.6162275772167
"192.168.7.33",57996,"172.26.211.223",6002,1251,1464943,1006,1446575,245,18368,378.884824436,5.4733131160000426,2114368.345960332,26847.358608160223
"192.168.7.33",57998,"172.26.211.223",6002,34,2961,18,1657,16,1304,384.714635096,5.568825806999996,2380.394082956815,1873.2853857427197
"192.168.7.33",58000,"172.26.211.223",6002,916,1017605,697,1000997,219,16608,384.890666894,5.265914289000023,1520719.016776987,25230.946177293437
"192.168.7.33",58002,"172.26.211.223",6002,33,2884,17,1580,16,1304,391.735624768,6.839210729000001,1848.1664772227546,1525.3222065180203
"192.168.7.33",58004,"172.26.211.223",6002,742,801397,549,787581,193,13816,392.003693219,5.408366609999973,1164981.6764178327,20436.484426857398
"192.168.7.33",58006,"172.26.211.223",6002,21,1592,11,896,10,696,398.658211551,7.760208874999989,923.6864774467826,717.5064601595543
"192.168.7.33",58008,"172.26.211.223",6002,277,285797,197,279997,80,5800,404.195204335,1.7412589729999581,1286411.7484723243,26647.386011776845
"192.168.7.33",58010,"172.26.211.223",6002,18,1386,9,760,9,626,410.817627747,1.8587035569999557,3271.0971994982547,2694.3511143235623
"192.168.7.33",58012,"172.26.211.223",6002,2,152,2,152,0,0,410.934532423,1.0654301650000093,1141.3230448567124,0
"192.168.7.33",58014,"172.26.211.223",6002,18,1375,9,748,9,627,412.728275297,21.03045485800004,284.53973251670635,238.511246374298
"192.168.7.33",58016,"172.26.211.223",6002,13,1080,10,852,3,228,412.846534169,37.473436515,181.888842707865,48.67447903449908
"192.168.7.33",58018,"172.26.211.223",6002,10,745,6,461,4,284,424.797432968,2.1654823439999973,1703.084770106075,1049.1888822345452
"192.168.7.33",58020,"172.26.211.223",6002,15,1284,10,919,5,365,445.706630227,2.224036242000011,3305.701526423221,1312.928244988548
"192.168.7.33",58022,"172.26.211.223",6002,27,2003,16,1238,11,765,461.769537837,7.060713802000009,1402.6910419729243,866.7678894259184
"192.168.7.33",58024,"172.26.211.223",6002,21,16607,16,16255,5,352,462.306343788,6.499725244999979,20006.99954202455,433.24908266949507
"192.168.7.33",58026,"172.26.211.223",6002,22,1697,13,1056,9,641,468.688193613,6.897785856999974,1224.7408335280293,743.4269642911618
"192.168.7.33",58028,"172.26.211.223",6002,38,38529,29,37741,9,788,475.301463494,1.3654198499999666,221124.65993518944,4616.89494260696
"192.168.7.92",43666,"172.26.211.223",6003,36,3116,18,1676,18,1440,6.595821442,5.968708574999999,2246.3820827439213,1930.06575128356
"192.168.7.92",43668,"172.26.211.223",6003,272,234919,160,226643,112,8276,7.046378156,5.4725217850000005,331317.82224600133,12098.261569551703
"192.168.7.92",43670,"172.26.211.223",6003,39,3606,20,2085,19,1521,13.538267169000001,8.036683149999998,2075.483092798054,1514.0574504296592
"192.168.7.92",43672,"172.26.211.223",6003,347,291223,199,281507,148,9716,13.679695322,7.853372654000001,286762.91056339315,9897.403755622163
"192.168.7.92",43674,"172.26.211.223",6003,30,2192,16,1236,14,956,25.778696098,4.675958130999998,2114.6468216740336,1635.600616116809
"192.168.7.92",43676,"172.26.211.223",6003,256,233183,160,226643,96,6540,25.966356762,4.796444435999998,378018.34758917254,10908.080078507559
"192.168.7.92",43678,"172.26.211.223",6003,27,1976,14,1100,13,876,34.569688921,8.450200510000002,1041.3954070777427,829.3294332728204
"192.168.7.92",43680,"172.26.211.223",6003,108,85719,60,82443,48,3276,40.216103396,2.775856521999998,237600.17665639293,9441.410170982901
"192.168.7.92",43682,"172.26.211.223",6003,30,2159,16,1190,14,969,42.992140226,6.081969169000004,1565.2825154924742,1274.5871911867291
"192.168.7.92",43684,"172.26.211.223",6003,549,440031,296,422755,253,17276,43.188424042,6.275633769000002,538916.0879187051,22022.954985472792
"192.168.7.92",43686,"172.26.211.223",6003,32,2796,16,1492,16,1304,49.216359354,6.772258159000003,1762.4844947970028,1540.4019981335734
"192.168.7.92",43688,"172.26.211.223",6003,613,501623,339,483387,274,18236,49.580757112,6.399008140999996,604327.4074340644,22798.533270376738
"192.168.7.92",43690,"172.26.211.223",6003,36,3116,18,1676,18,1440,56.020321478,5.314085265999999,2523.1059211235474,2167.8237031133103
"192.168.7.92",43692,"172.26.211.223",6003,895,776613,524,750145,371,26468,56.130708257,5.159695823999996,1163084.0663292566,41038.078061711756
"192.168.7.92",43694,"172.26.211.223",6003,24,1796,12,964,12,832,62.63257089,7.5383419559999965,1023.0366365725534,882.9527817721623
"192.168.7.92",43696,"172.26.211.223",6003,313,288149,197,279997,116,8152,67.891030617,1.8150925320000084,1234083.6406460349,35929.8486717589
"192.168.7.92",43698,"172.26.211.223",6003,36,3095,18,1655,18,1440,69.606698794,5.510966625000009,2402.482341289806,2090.377384566357
"192.168.7.92",43700,"172.26.211.223",6003,933,857863,581,832351,352,25512,69.775064919,5.297979777999998,1256857.9494491233,38523.363348330255
"192.168.7.92",43702,"172.26.211.223",6003,36,3111,18,1671,18,1440,76.553266294,5.3998380410000095,2475.6298056532723,2133.3973190548845
"192.168.7.92",43704,"172.26.211.223",6003,662,565649,382,545381,280,20268,76.662671792,5.196478021000004,839616.3675412564,31202.672145392273
"192.168.7.92",43706,"172.26.211.223",6003,40,3388,20,1812,20,1576,83.557741061,6.283650072,2306.939411631832,2006.4771041566046
"192.168.7.92",43708,"172.26.211.223",6003,356,303171,206,292975,150,10196,83.72765856,6.055164542,387074.5350919648,13470.814778727445
"192.168.7.92",43710,"172.26.211.223",6003,36,3401,18,1960,18,1441,90.559201311,7.893863035999999,1986.3531870886645,1460.374970711615
"192.168.7.92",43712,"172.26.211.223",6003,377,317947,217,307463,160,10484,90.696385491,7.755763510999998,317145.3070366834,10814.151292911956
"192.168.7.92",43714,"172.26.211.223",6003,39,3568,20,2047,19,1521,98.477055246,6.743527063999991,2428.4027993929944,1804.3969994512674
"192.168.7.92",43716,"172.26.211.223",6003,503,414871,281,399739,222,15132,98.58046311,6.616014657999997,483359.26767228777,18297.420162698807
"192.168.7.92",43718,"172.26.211.223",6003,32,2321,16,1216,16,1105,105.241682906,7.46046101200001,1303.940866972255,1184.9133700693599
"192.168.7.92",43720,"172.26.211.223",6003,403,343109,234,331977,169,11132,105.333646793,7.895850914999997,336355.89483518014,11278.835043708526
"192.168.7.92",43722,"172.26.211.223",6003,18,1386,9,760,9,626,112.914304012,5.588176770999993,1088.011394262318,896.1778063265933
"192.168.7.92",43724,"172.26.211.223",6003,42,3751,23,2242,19,1509,118.577914292,7.746617512,2315.3331079294935,1558.3575646144538
"192.168.7.92",43726,"172.26.211.223",6003,342,289227,197,278623,145,10604,118.708294971,7.5264515450000005,296153.37143580854,11271.181312042845
"192.168.7.92",43728,"172.26.211.223",6003,33,2372,16,1236,17,1136,130.683570519,4.632146946999995,2134.647305695678,1961.9412130018527
"192.168.7.92",43730,"172.26.211.223",6003,221,195943,134,189151,87,6792,130.853258387,5.1516832479999835,293730.7918897123,10547.232309186447
"192.168.7.92",43732,"172.26.211.223",6003,25,1876,13,1032,12,844,134.090371463,7.239441735000014,1140.4194276590838,932.6686016901808
"192.168.7.92",43734,"172.26.211.223",6003,255,232573,159,225201,96,7372,136.104831605,11.655118471000009,154576.54973501287,5060.0944251869
"192.168.7.92",43848,"172.26.211.223",6003,36,3116,18,1676,18,1440,489.703113237,5.496658910999997,2439.299985154201,2095.8186029964495
"192.168.7.92",43850,"172.26.211.223",6003,589,530341,359,513601,230,16740,489.91707561,5.331601521000039,770651.7420359123,25118.156237392788
"192.168.7.92",43852,"172.26.211.223",6003,25,1852,13,1032,12,820,496.70056289,7.2752314779999665,1134.8092531441566,901.6895228471011
"192.168.7.92",43854,"172.26.211.223",6003,338,294247,200,284323,138,9924,501.861797032,2.120216510999967,1072807.4176383186,37445.2324034379
"192.168.7.92",43856,"172.26.211.223",6003,36,3097,18,1656,18,1441,503.852211367,5.339989057000025,2480.9039603992464,2158.8059220623877
"192.168.7.92",43858,"172.26.211.223",6003,1310,1243089,841,1208645,469,34444,504.045691785,5.070569651000028,1906917.8939476807,54343.40103101731
"192.168.7.92",43860,"172.26.211.223",6003,35,2890,19,1769,16,1121,510.682553625,7.012070358000017,2018.234170148349,1278.9375380080833
"192.168.7.92",43862,"172.26.211.223",6003,448,381687,259,368015,189,13672,511.224351737,5.580022314999951,527617.9616855216,19601.355303899167
"192.168.7.92",43864,"172.26.211.223",6003,36,3096,18,1656,18,1440,517.715478816,5.290811933999976,2503.9635060292544,2177.359570460221
"192.168.7.92",43866,"172.26.211.223",6003,231,197397,135,190593,96,6804,517.821699673,5.110848886999975,298334.78424266464,10650.285540324618
"192.168.7.92",43868,"172.26.211.223",6003,39,3336,20,1816,19,1520,524.704157305,5.915499304000036,2455.9211747647787,2055.616842314132
"192.168.7.92",43870,"172.26.211.223",6003,282,234341,160,225257,122,9084,524.864538095,5.637011918000098,319682.843714713,12891.936553822758
"192.168.7.92",43872,"172.26.211.223",6003,38,3223,19,1714,19,1509,531.697086944,7.227716557999997,1897.141357158351,1670.2370524807186
"192.168.7.92",43874,"172.26.211.223",6003,339,286051,194,275671,145,10380,531.816157378,7.092205808000017,310956.5711576421,11708.62806975099
"192.168.7.92",43876,"172.26.211.223",6003,34,2409,19,1371,15,1038,538.986618523,7.612893308000025,1440.7137413149155,1090.781082045866
"192.168.7.92",43878,"172.26.211.223",6003,328,273719,187,264203,141,9516,539.138607497,7.5325633100000005,280598.23900769843,10106.519768500955
"192.168.7.92",43880,"172.26.211.223",6003,20,1524,11,896,9,628,546.714029456,7.2337685679999595,990.9081183090512,694.5204222076833
"192.168.7.92",43882,"172.26.211.223",6003,117,108516,77,105620,40,2896,547.361615569,9.608323322999922,87940.42119475488,2411.2427549707454
